****************
S *            *
* ***** ****** *
*            * *
* *** ****** ***
*   *   *      *
*** ******** ***
*          *   *
********G*******
