*S*****************************
*   *                   *     *
*** ******* ***** * *** *** * *
*         * *   * *   *     * *
***** *** * *** * *** *** *****
*   * *   *     *       *     *
*** * *** * * *** * * ******* *
*     *   * *   * * *   *     *
*** ***** *** * * * *** * *****
*     *         * * *   *   * *
* *********** ********* ***** *
* * *   *   * *   *     *     *
* *** * * *** * *** ***** *** *
*     *     *   *     *     * *
* ********* ********* * ***** *
* *   *     *         * *     *
* * ******* *** ******* *** ***
* * * *   * *   * *     * *   *
*** * * *** * *** * * *** * * *
*           *       *     * * *
*****************************G*
