******************************
S *     *     *              *
* * * *** ***** ************ *
* * * * *  * ** *        * * *
* * * * *  * ** * *** *  * * *
*   *           * *   *      *
***************** ***** ******
*                     *    * *
*** ********* ************** *
*    * * *       *           *
* **** * * ***** *** **** ****
*      * * *   * *   *     * G
***  * * * ***** *** ******* *
*    *   *       *         * *
* ***************** **** * * *
*     *      *      *  * * * *
* ***** **** * **** **** * * *
*       *      *         *   *
******************************
